9 9
#########
#-P-#####
#-OO#####
#-O-###X#
###----X#
###----X#
##---#--#
##---####
#########