10 10
##########
#--------#
#---XX-O-#
#---O----#
#--------#
#----P---#
#--O-----#
#-----X--#
#--------#
##########
