#########
## @...##
##   ####
###$    #
#   #$# #
# $ #   #
#   #####
#########
