#########
#@  #####
# $$#####
# $ ###.#
### ###.#
###    .#
##   #  #
##   ####
#########
