######
##  ##
#@$ ##
##$ ##
## $ #
#.$  #
#..*.#
######
