##########
##     ###
##$###   #
# @ $  $ #
# ..# $ ##
##..#   ##
##########
