########
##@ ####
## $  ##
### # ##
#.# #  #
#.$  # #
#.   $ #
########
