#############
####     ####
#   .### ####
# # #    ####
# # $ $#. ###
# #  *  # ###
# .#$ $ # ###
##    # # ###
## ###.    @#
##     ##   #
#############
