##########
####  # @#
###   #  #
###$ $ $ #
### $##  #
### $ # ##
#.....  ##
##########
