##########
####    ##
##. $## ##
#..$ $  @#
#.. $ $ ##
######  ##
##########
