###########
##  ##   ##
##   $   ##
##$ ### $##
## #...# ##
## #...# ##
# $  $  $ #
#     # @ #
###########
