#######
##  . #
# * # #
# .$  #
#  #$##
## @ ##
#######
