BAB01209 10 9
#####-----
#-P-#-----
#-OO#-###-
#-O-###X#-
###----X#-
-##----X#-
-#---#--#-
-#---####-
-#####----