BAB01209 10 10  
----------
---###----
---#X#----
---#-####-
-###O-OX#-
-#X-OP###-
-####O#---
----#X#---
----###---