7 7
#######
##--X-#
#-o-#-#
#-XO--#
#--#O##
##-P-##
#######
