BAB01209 10 10
##########
#        #
#    X   #
#      O #
#  O     #
#    P   #
#        #
#     X  #
#        #
##########