8 7
########
###   ##
# B # ##
# BXBX #
# ##X  #
#  P ###
########
